['gas', 'fill', 'tire', 'pump', 'credit card', 'windshield', 'salty', 'snack', 'soft drink', 'hot dog', 'besides', 'harmless']	
skiing	滑雪（運動）
shell	殼，果殼；莢
waterproof	不透水的，防水的
instructor	教員；教練；指導者
breathe	呼吸；呼氣；吸氣
equipment	配備，裝備
learning	學，學習
eventually	最後，終於
convenience	方便；合宜
learned	有學問的，博學的；精通的
smoking	冒煙，冒氣
vapor	水汽，汽，蒸汽；煙霧
credit	賒帳，賒欠
elementary	基本的
athletic	運動的，體育的；運動員的，體育家的
mostly	大多數地，大部分地；主要地
attached	依戀的，充滿愛心的
windshield	（摩托車的）擋風玻璃
addicted	沉溺於某種（尤其是不良的）嗜好的；入了迷的
checked	格子花紋的
bent	彎曲的
